0000000000000000000000000000000000000000000000000000000000000000
0                                                              0
0                                                              0
0                                                              0
0                                          b                   0
0                                                              0
0                                                              0
0                                                              0
0                                                              0
0                                                              0
0                                                              0
0                                                              0
0                                                              0
0                                                              0
0                                                              0
0                                                              0
0                                                              0
0                                                              0
0    fffffffff                                                 0
0                                                              0
0                                                              0
0                                                              0
0           ffffff                                             0
0                                                              0
0                                                              0
0                                                              0
0                                                              0
0      ffffffff                                                0
0                                                              0
0                                 e                            0
0                                                              0
l                                                              r
fffffffffffffffffffffffffffffffffffffffffffffffffffffffffffffffff
zzzzzzzzzzzzzzzzzzzzzzzzzzzzzzzzzzzzzzzzzzzzzzzzzzzzzzzzzzzzzzzzz
zzzzzzzzzzzzzzzzzzzzzzzzzzzzzzzzzzzzzzzzzzzzzzzzzzzzzzzzzzzzzzzzz
zzzzzzzzzzzzzzzzzzzzzzzzzzzzzzzzzzzzzzzzzzzzzzzzzzzzzzzzzzzzzzzzz